111111111
1E0000001
101001011
1010010C1
1P0000001
111111111