1111111111
1E00C0N001
10100101N1
1010010C01
1P00000001
1111111111
