1111111111111111111111111111111111
1E1010100000000C00000C000000000001
101011P100100000101001000000010101
1100010000101010001001000000010101
100000000C00C0000000000000000000C1
1111111111111111111111111111111111
