1111111111111111111111111111111111
10000000000000000000000000000000E1
1000001111111110000000000000000001
1000001111111110000000000000000001
100000100C000110000000000000000001
100000110000C1100000000C0000000001
100P000111111110000000000000000001
1000001111111110000000000000000001
1000000000000000000000C00000000001
10000000000C0000000000000000000001
1000000000000000000000000000000001
1000000000000000000000000000000001
1111111111111111111111111111111111
